*** Settings ***
Library	String
Library	Collections
Library	OperatingSystem
Library	DateTime
Library	C:/Ath.Git/AdaptiveTelehealth/ATH-Framework/ATHLibrary


*** Variables***
${BROWSER}	Chrome
${URL}	https://groups1.secure.adaptivetelehealth.com/index.php/login
#${URL}	https://automation.adaptivetelehealth.com/index.php/login
${AutoTherapist1}	automationTherapist@gmail.com
${AutoClient1}	automationclient143@gmail.com
${AutoClient3}	democlient4524@gmail.com
${AutoTherapist}	ninaf+therapist@adaptivetelehealth.com
${AutoSupervisor}	ninaf+supervisor@adaptivetelehealth.com
${AutoClient}	ninaf+client@adaptivetelehealth.com
${AutoAdmin}	ninaf+admin@adaptivetelehealth.com
${AutoClient2}	beyoncehalo@mailinator.com
${AutoSystemAdmin}	seerapup+dv380g2@yopmail.com
${AutoSystemAdmin1}	ninaf@adaptivetelehealth.com
${TestEnv}	Secure
#${TestEnv}	Live
${Password}	Password123!!!

